#размер 100x100
20:40
%%
2:water:0.5
1:dirt:1.0
%%
1:1:1:1:1:1:1:1:1:1:1:1:1:1:1:1:1:1:1:1
1:1:1:1:1:1:1:1:1:1:1:1:1:1:1:1:1:1:1:1
1:1:1:1:1:1:1:1:1:1:1:1:1:1:1:1:1:1:1:1
1:1:1:1:1:1:1:1:1:1:1:1:1:1:1:1:1:1:1:1
1:1:1:1:1:1:1:1:1:1:1:1:1:1:1:1:1:1:1:1
1:1:1:1:1:1:1:1:1:1:1:1:1:1:1:1:1:1:1:1
1:1:1:2:2:2:2:2:1:1:1:1:1:1:1:1:1:1:1:1
1:1:1:2:2:2:2:2:1:1:1:1:1:1:1:1:1:1:1:1
1:1:1:2:2:2:2:2:1:1:1:1:1:1:1:1:1:1:1:1
1:1:1:2:2:2:2:2:2:2:2:2:2:2:1:1:1:1:1:1
1:1:1:1:1:1:1:1:2:2:2:2:2:2:2:1:1:1:1:1
1:1:1:1:1:1:1:1:1:2:2:2:2:2:2:1:1:1:1:1
1:1:1:1:1:1:1:1:1:1:1:1:1:1:1:1:1:1:1:1
1:1:1:1:1:1:1:1:1:1:1:1:1:1:1:1:1:1:1:1
1:1:1:1:1:1:1:1:1:1:1:1:1:1:1:1:1:1:1:1
1:1:1:1:1:1:1:1:1:1:1:1:1:1:1:1:1:1:1:1
1:1:1:1:1:1:1:1:1:1:1:1:1:1:1:1:1:1:1:1
1:1:1:1:1:1:1:1:1:1:1:1:1:1:1:1:1:1:1:1
1:1:1:1:1:1:1:1:1:1:1:1:1:1:1:1:1:1:1:1
1:1:1:1:1:1:1:1:1:1:1:1:1:1:1:1:1:1:1:1
1:1:1:1:1:1:1:1:1:1:1:1:1:1:1:1:1:1:1:1
1:1:1:1:1:1:1:1:1:1:1:1:1:1:1:1:1:1:1:1
1:1:1:1:1:1:1:1:1:1:1:1:1:1:1:1:1:1:1:1
1:1:1:1:1:1:1:1:1:1:1:1:1:1:1:1:1:1:1:1
1:1:1:1:1:1:1:1:1:1:1:1:1:1:1:1:1:1:1:1
1:1:1:1:1:1:1:1:1:1:1:1:1:1:1:1:1:1:1:1
1:1:1:1:1:1:1:1:1:1:1:1:1:1:1:1:1:1:1:1
1:1:1:1:1:1:1:1:1:1:1:1:1:1:1:1:1:1:1:1
1:1:1:1:1:1:1:1:1:1:1:1:1:1:1:1:1:1:1:1
1:1:1:1:1:1:1:1:1:1:1:1:1:1:1:1:1:1:1:1
1:1:1:1:1:1:1:1:1:1:1:1:1:1:1:1:1:1:1:1
1:1:1:1:1:1:1:1:1:1:1:1:1:1:1:1:1:1:1:1
1:1:1:1:1:1:1:1:1:1:1:1:1:1:1:1:1:1:1:1
1:1:1:1:1:1:1:1:1:1:1:1:1:1:1:1:1:1:1:1
1:1:1:1:1:1:1:1:1:1:1:1:1:1:1:1:1:1:1:1
1:1:1:1:1:1:1:1:1:1:1:1:1:1:1:1:1:1:1:1
1:1:1:1:1:1:1:1:1:1:1:1:1:1:1:1:1:1:1:1
1:1:1:1:1:1:1:1:1:1:1:1:1:1:1:1:1:1:1:1
1:1:1:1:1:1:1:1:1:1:1:1:1:1:1:1:1:1:1:1
1:1:1:1:1:1:1:1:1:1:1:1:1:1:1:1:1:1:1:1
1:1:1:1:1:1:1:1:1:1:1:1:1:1:1:1:1:1:1:1
1:1:1:1:1:1:1:1:1:1:1:1:1:1:1:1:1:1:1:1
1:1:1:1:1:1:1:1:1:1:1:1:1:1:1:1:1:1:1:1
1:1:1:1:1:1:1:1:1:1:1:1:1:1:1:1:1:1:1:1
