300:-200:0:2
300:400:0:2
-100:200:0:1
-100:300:0:1
-100:350:0:1
-100:400:0:1
